###################################
#A  #   #     #   # #   # # #   # #
### # # # # # # # # # # # # # # # #
#   # # # #   # #   #   # #   # # #
# ### # # ##### ######### # # # ###
#   # #     # #               #   #
# # ### ### # ### ##### # # ##### #
# #     #   #   #   # #   #   #   #
# ### ##### ##### # # # ##### # ###
#   #       #   #   # #   #   #   #
##### ##### # ### ##### # ##### ###
#   # #   # #   # #     #   # #   #
# # # # ### ##### # ####### # # ###
# #   #     #     # #   #   #     #
# # ##### # ### ##### # # # # ### #
# #     # # #   #   #   #   # #   #
# ### # ### # ##### ##### # ### # #
#   # #   #   #   #     #   # #   #
##### ### ####### ##### ####### ###
#   #   #     #   #   # #   #     #
# ### ### ### # # ### # # ### #####
#   #   #   # # #   # # #   # #   #
# # # ##### # # # ### # ##### # ###
# #     #   #   #   #   #   #     #
# ##### ### ### ### # ### ##### ###
#     #   #     #   # #     #     #
# ### ##### # # ##### ### ### #####
#   # #   # # #   #   # #   # #   #
# # ### ### ### # ### # # ### # ###
# #   #   #   # # #   # #   #   B #
###################################
